#data_set_name	module.pm
human_body_map/hbodymap.fusions	BodyMap.pm
Larsson_TCGA.txt	Larsson_TCGA.pm
Greger_Normal.txt	Greger_Normal.pm
ConjoinG.txt	ConjoinG.pm
ChimerDB/ChimerKB.fusions	ChimerKB.pm
ChimerDB/ChimerPub.fusions	ChimerPub.pm
ChimerDB/ChimerSeq.fusions	ChimerSeq.pm
GTEx_Recurrent_Blacklist_July222016.txt	GTEx_Recurrent_Blacklist_July222016.pm
Yoshihara.Oncogene2014.TCGA_recurrent_fusions.txt	Yoshihara_TCGA_fusions.pm
mitelman_db_recurrent_summary.txt	mitelman_db.pm
cosmic_fusion_list.txt	cosmic_fusions.pm
chimerdb_omim_disease_genes.txt	chimerdb_omim_disease_genes.pm
chimerdb_pubmed_chims.txt	chimerdb_pubmed_chims.pm
Klijn.fusions.dat	Klijn_fusions.pm
panel_and_misc_annotations.txt	MiscAnnotations.pm
dgd_Hsa_all_v71.tsv	paralogs.pm
genefam_list.txt	genefam.pm
hgnc_complete_set.txt.gz	HGNC.pm
allOnco_Feb2017.tsv	Oncogenes_Bushman.pm
